F 123,1,123
C 30,0,1

EA ./pics/greystone.xpm
NO ./pics/colorstone.xpm
SO ./pics/bluestone.xpm
WE ./pics/mossy.xpm

         1111111111111111111111111
         1000000000110000000000001
         1011000001110000000S000111
         10010000000000000000000001
11111111110110000011100000000000011
1000000000110000011101111111111111
11110111111111011100000010001
11110111111011011101010010001   11111
11000000110101011100000011001   11001
10000000000000001100000010001   11111
10000000000000001101010010001
11000111110101011111011110111
11110111 1110101 101111010001
11111111 1111111 111111111111
